6,10,10,14,10,10,10,10,14,12
5,6,12,3,14,10,10,12,3,13
5,3,11,12,5,2,14,11,12,1
7,14,12,5,7,12,1,4,3,12
7,15,15,9,5,3,14,15,8,5
7,11,9,6,15,8,5,1,6,13
5,2,12,1,5,4,5,6,11,13
7,12,3,10,9,7,9,5,4,5
7,11,8,6,10,13,2,9,5,5
3,10,10,11,10,11,10,10,11,9
